SO textures/wolfenstein/purple_stone.xpm
NO textures/wolfenstein/blue_stone.xpm
WE textures/wolfenstein/red_brick.xpm        
F 212, 135, 209
C 255 , 1,1

EA textures/wolfenstein/wood.xpm


        11111111111 1111111111111       11111
        1000000000110000000000001           1
        1011000001110000000000001111111111111
        1001000000000000000000001
111111111011000001110000000000001
100000000011000001110111111111111
11110111111111011100000010001
11110111111111011101010010001
11000000110101011100000010001
10000000000000011000001 1001
10000000000000001101010010001
110000010101010111110110E0111
11110111 1110101 101111010001
11111111 1111111 111111111111
