SO textures/wolfenstein/purple_stone.xpm
NO textures/wolfenstein/grey_stone.xpm


                 C 225     , 27 ,    23           


WE textures/wolfenstein/red_brick.xpm

F 220,7,223


EA textures/wolfenstein/wood.xpm



        111111111111 1111111111111
        1000000000111000000000001
        1011000001110000000000001
        1001000000000000000000001
        1011000001110000000000001
        1000000000110000011111111
        101111011110111000001
11111111111111011101010010001
11000000110101011100000010001
10000000000000001100000010001
10000000000000001101010010001
10000000000000000000000000001
11000001110101011111011110N0111
11110111 1110101 101111010001
11111111 1111111 111111111111



2147483647



